1,1,1,1,1,1,1,1,1,1,1,1,1,1,1,1,1,1,1,1,1,1,1,1,1;
1,0,0,0,0,0,0,0,0,0,0,0,0,0,0,0,0,0,0,0,0,0,0,0,1;
1,0,0,0,0,0,0,0,0,0,0,0,0,0,0,0,0,0,4,0,0,0,0,0,1;
1,0,0,8,0,0,0,0,0,0,5,0,0,0,0,0,0,0,7,0,0,0,0,0,1;
1,0,1,1,1,0,0,0,1,1,1,1,0,0,0,0,0,0,0,0,0,0,0,0,1;
1,0,0,0,0,0,0,0,0,0,0,0,0,0,1,1,1,1,0,0,0,0,0,0,1;
1,0,0,0,0,0,0,0,0,0,0,0,0,0,1,0,0,1,0,0,15,0,0,2,1;
1,0,0,0,0,0,7,0,0,0,0,0,0,1,1,0,0,1,1,1,1,1,1,1,1;
1,0,0,0,0,1,1,1,0,0,0,1,1,1,1,0,0,0,0,0,0,0,0,0,0;
1,0,9,0,0,0,0,1,0,13,0,1,0,0,0,0,0,0,0,0,0,0,0,0,0;
1,1,1,1,1,1,1,1,1,1,1,1,0,0,0,0,0,0,0,0,0,0,0,0,0;